const collisionsLevel2 = [
  292, 292, 292, 292, 292, 292, 292, 0, 0, 0, 0, 0, 0, 0, 0, 0, 292, 0, 0, 0, 0,
  0, 292, 0, 0, 0, 0, 0, 0, 0, 0, 0, 292, 0, 0, 0, 0, 0, 292, 0, 0, 0, 0, 0, 0,
  0, 0, 0, 292, 292, 292, 292, 0, 0, 292, 0, 0, 0, 0, 0, 0, 0, 0, 0, 0, 0, 0,
  292, 0, 0, 292, 0, 0, 292, 292, 292, 292, 292, 292, 0, 0, 292, 292, 292, 0, 0,
  292, 292, 292, 292, 0, 0, 0, 0, 292, 0, 0, 292, 0, 0, 0, 0, 0, 0, 0, 0, 0, 0,
  0, 0, 292, 0, 0, 292, 0, 0, 0, 0, 0, 0, 0, 0, 292, 292, 292, 292, 292, 0, 0,
  292, 292, 292, 292, 292, 292, 292, 292, 292, 292, 292, 0, 0, 0, 0,
]
