
const collisionsLevel3 = [
  0, 0, 0, 0, 0, 0, 0, 0, 0, 0, 0, 0, 0, 0, 0, 0, 0, 250, 250, 250, 250, 250,
  250, 250, 250, 250, 250, 250, 250, 250, 250, 0, 0, 250, 0, 0, 0, 0, 0, 0, 0,
  0, 0, 0, 0, 0, 250, 0, 0, 250, 0, 0, 0, 0, 0, 0, 0, 0, 0, 0, 0, 0, 250, 0, 0,
  250, 0, 0, 0, 0, 0, 0, 0, 0, 250, 250, 250, 250, 250, 0, 0, 250, 0, 0, 0, 0,
  0, 0, 0, 0, 0, 0, 0, 250, 0, 0, 0, 250, 250, 0, 0, 0, 0, 0, 0, 0, 0, 0, 250,
  250, 0, 0, 0, 250, 250, 250, 250, 250, 250, 250, 250, 250, 250, 250, 250, 250,
  0, 0, 0, 0, 0, 0, 0, 0, 0, 0, 0, 0, 0, 0, 0, 0, 0, 0,
]